10 10
9 8 7 6 5 4 2 3 2 4
5 8 7 6 5 4 2 3 2 4
7 7 7 6 5 4 2 5 2 4
3 8 7 6 6 4 2 2 1 4
5 7 7 6 7 4 2 1 2 4
8 7 6 5 9 2 3 2 4 8
3 5 7 6 5 4 2 3 2 4
2 5 7 6 4 4 3 5 3 2
2 4 7 6 3 4 2 3 2 1
2 2 7 6 5 4 2 3 1 4
